mapa:
                                                                                                                                                                                                                                                
                                                                                                                                                                                                                                                
                                                                                                                                                                                                                                                
                                                                                                                                                                                                                                                
                                                                                                                                                                                                                                                
                                                                                                                                                                                                                                                
                                                                                                                                                                                                                                                
                                                                                                                                                                                                                                                
                                                                                                                                                                                                                                                
                                                                                                                                                                                                                                                
                                                                                                                                                                                                                                                
                                                                                                                                                                                                                                                
                                                                                                                                                                                                                                                
                                                                                                                                                                                                                                                
                                                                                                                                x                                                                                                               
                                                                                                                                                                                                                                                
                                                            x   x x x x x x x x                                               x x                                                                                                               
                                        x x x x x x x x x x x x x x x x x x x x x x x x x x x x x x x x x x x x x x x x x x x x x x                                                                                                             
                                            x   x     x x x x x x x x x x x x x x x x x x x x x x x x x x x x x x x x x x x x x x x x                                                                                                           
                                            x x x x x x x x x x x x     x x x x   x       x   x       x   x x x x x x       x x x x                                                                                                             
                                                                                                                            x x x x x                                                                                                           
                                                                                                                              x x x x                                                                                                           
                                                                                                                              x x x x                                                                                                           
                                                                                                                              x x x x x x x                                                                                                     
                                                                                                                            x x x x x x x                                                                                                       
                                                                                                                              x     x x x                                                                                                       
                                                                                                                                    x x x                                                                                                       
                                                                    x x x                 x                                         x x x                                                                                                       
                                                            x     x x x x x x x x x x x x x x x x x                               x x x x                                                                                                       
                                                            x   x x x x x x x x x x x x x x x x x x                               x x x x                                                                                                       
                                                                  x x x x x x x x x x x x x x x                                   x x x x                                                                                                       
                                                                  x x                                                             x x x x x                                                                                                     
                                                                  x                                                               x x x x x                                                                                                     
                                                                x x                                                               x x x x                                                                                                       
                                                                x x                                                               x x x x                                                                                                       
                                                                  x                                                               x x x x                                                                                                       
                                                                  x                                                             x x x x x                                                                                                       
                                                                  x                           x                                   x x x x                                                                                                       
                                                                  x                   x x x x x x x x                             x x x                                                                                                         
                                                                  x             x     x x x x x x x x                           x x x x x                                                                                                       
                                                                x x                             x x x                           x x x x x                                                                                                       
                                                                x x                             x x x                           x x x x                                                                                                         
                                                                x x                   x         x x x                           x x x x                                                                                                         
                                                                x x               x x x x x x x x x x                           x x x x                                                                                                         
                                                            x x x x             x x x x x x x x x x                             x x x x                                                                                                         
                                                                                      x x x x   x x x                           x x x x                                                                                                         
                                                                                                x                               x x x x                                                                                                         
                                                                                                                                x x x x                                                                                                         
                                                                                                                                x x x                                                                                                           
                                                                                                                                x x x                                                                                                           
                                                                                                                                x x x                                                                                                           
                                                                                                                                x x x                                                                                                           
                                                                                                                                x x x                                                                                                           
                                                                                                                              x x x x                                                                                                           
                                                                                              x   x x       x x               x x x x                                                                                                           
                                                                                            x x x x x x x x x                   x x x                                                                                                           
                                                                                              x x x x     x x                   x x x                                                                                                           
                                                                                                x                                 x x                                                                                                           
                                                                                                x                                 x x                                                                                                           
                                                                                                x                                 x x                                                                                                           
                                                                x x x x x x x x x x x x x     x x x                               x x                                                                                                           
                                                                      x x x x x x x x x x     x x                                 x x                                                                                                           
                                                                                              x x                               x x x                                                                                                           
                                                                                              x x                                 x x x                                                                                                         
                                                                                              x x                                 x x                                                                                                           
                                                                                              x x                               x   x x                                                                                                         
                                                                                              x x                                   x x                                                                                                         
                                                                                              x x                                 x x x                                                                                                         
                                                                                              x x                                 x x x x                                                                                                       
                                                                                              x x                                 x x x                                                                                                         
                                                                                              x x                                 x x x                                                                                                         
                                                                                              x x                                 x x x x                                                                                                       
                                                                                              x x                             x x x x x                                                                                                         
                                                                                              x x x                         x x x x x                                                                                                           
                                                                                              x x x                           x x                                                                                                               
                                                                                              x x                             x x                                                                                                               
                                                                                            x x x x x x x x x x x x x x x x x x x                                                                                                               
                                                                                            x x x x x x x x x x x x x x x x x x                                                                                                                 
                                                                                            x                                                                                                                                                   
                                                                                                                                                                                                                                                
                                                                                                                                                                                                                                                
                                                                                                                                                                                                                                                
                                                                                                                                                                                                                                                
                                                                                                                                                                                                                                                
                                                                                                                                                                                                                                                
                                                                                                                                                                                                                                                
                                                                                                                                                                                                                                                
                                                                                                                                                                                                                                                
                                                                                                                                                                                                                                                
                                                                                                                                                                                                                                                
                                                                                                                                                                                                                                                
                                                                                                                                                                                                                                                
                                                                                                                                                                                                                                                
                                                                                                                                                                                                                                                
                                                                                                                                                                                                                                                
                                                                                                                                                                                                                                                
                                                                                                                                                                                                                                                
                                                                                                                                                                                                                                                
                                                                                                                                                                                                                                                
                                                                                                                                                                                                                                                
                                                                                                                                                                                                                                                
                                                                                                                                                                                                                                                
                                                                                                                                                                                                                                                
                                                                                                                                                                                                                                                
                                                                                                                                                                                                                                                
                                                                                                                                                                                                                                                
                                                                                                                                                                                                                                                
                                                                                                                                                                                                                                                
                                                                                                                                                                                                                                                
                                                                                                                                                                                                                                                
                                                                                                                                                                                                                                                
                                                                                                                                                                                                                                                
                                                                                                                                                                                                                                                
                                                                                                                                                                                                                                                
                                                                                                                                                                                                                                                
                                                                                                                                                                                                                                                
                                                                                                                                                                                                                                                
                                                                                                                                                                                                                                                
                                                                                                                                                                                                                                                
                                                                                                                                                                                                                                                
